1111111111111
1111X00011000
1100000011111
1111111011111
11111110Y0111